1111111111111111111111
11000010C0000000111111
1100101111100000110111
1100100000000101111111
11001000P00001E1111111
110001111101000000C111
1111111111111111111111
1111101111111111111101
1110110111111011011111
1111111111111111111111