1111111111111111111111111111111111
100C00000000000C00000C000000000001
1010010100100000101001000000010101
10110111101010100C1001000000010101
1001P1E00C00000000000000C0000000C1
1111111111111111111111111111111111